01000000000000
00100000000000
11100000000000
00000000000000
00000000000000
00000000000000
00000000000000
